Service strategy - Стратегия на услугите
Service design - Проектиране на услугите
Service transition - Преходи в услугите
Service operation - Опериране на услугите
Continual service improvement - Постоянно подобряване на услугите
ITIL Service Management Lifecycle - жизнения цикъл на услугите в ITIL

Event Management - Управление на събитията
Incident Management - Управление на ицидентите
Request Fulfilment - Изпълнение на заявки
Problem Management - Управление на проблемите
Access Management - Управление на достъпа

Service Desk - Сървис Деск
Technical Management - Управление на техниката
IT Operations Management - Управление на ИТ операциите
Application Management - Управление на приложенията
Monitoring and Control - Мониторинг и контрол

Change managemet - Управление на промените
Release Management - Управление на версиите
Asset Management - Управление на активите
Configuration Management - Управление на конфигурацията 
Availability Management - Управление на наличността
Information Security Management - Управление на информационната сигурност

Technical Management - Управление на техниката
Application Management - Управление на приложенията
IT Operations Management - Управление на ИТ операциите 

asset актив
impact въздействие
involved замесени
deployment разгръщане
release версия
tools средства
coding system система с кодове
responsiveness отговоряемост

Knowledge Management - Управление на знанията
knowledge management cycle - Цикъл за управление на знанията

Tacit Knowledge Неявното знание
Explicit Knowledge Изричното Знание
articulate изрази 
value-laden - натоварени със смисъл
Semantic mapping Семантичното картографиране
framework - платформа
knowledge worker - Работник занимаващ се с знания
tangible - осезаем
competitive advantage - конкурентно предимство
workforce - работна сила
codification of knowledge - кодификация на знания
know-how - ноу-хау
corporate memory - корпоративната памет
lessons learned - поуки
knowledge repository - хранилище на знания
knowledge refinery - рафинерия на знанията
front-end нещо с което потребителите взаимодействат директно
back-end нещо което подпомага front-end без да взаимодейства с потребителя
notion - идея
competitive intelligence - конкурентно разузнаване
competitive success - конкурентоспособност
knowledge items - елементи от знание
knowledge objects - обекти от знание
knowledge product - продукт на знание
deploy - разгръщам
generic - с широко приложение
bussiness processing environment - средата на работа на бизнес